IP: adapter, faceid
dpo: sdxl, text2image, sd1.5
sdxl: turbo, emoji, lora, dreambooth, subject, brainslug, planet, textures, wrong, betweenthefingersringvca, ver2, db, appu, instructpix2pix, tron, muppetshow, unstable, diffusers, sefo, halo, ring, black, light, tng, interior, khuze, 1e, 512x512images, abid, bzk, b16, e6, r128, geolora, merged, dataset, billie, eillish, neo, 0.9, usage, base, refiner, controlnet, seg, pokemon, lionelmessi, lower, decks, aesthetic, hamisamobetto, raisisamia, ugly, sonic, mulokoziepk, training, demo, model, nachito, mrcreddy, powerstar, archi04, amirth, mjbadera, archi06, javiergerardomilei, holding, deserteagle, botw, zelda64, richtilebati, richtilebati_two, dabble, mk1, fashion, part, panorama, moodewji, diamondplatnumz, headshot, portrait, harmonize, mbosso, self, train1500, magufuli, alikiba, mwijaku, rayvanny, vision, pro, barbie, samia, ommydimpos, vae, fix, diffus, basemodel, general, fantasy, pumpkin, head, futurama, style, index, modern, contemporary, luxury, classic, scandinavian, bird, ikea, international, 500steps, loft, 60batchsize, kream, isometric, geology, 70s, scifi, 2.0, cinematic, joker, caramex, moebius, lean, pixar, foundation, cyberpunk, pororo_1024_finetuning, starfield, akira, flintstones_finetuning_1, flintstones, with_new_tokens, after, finetuning, ships, friends, wilma, flintstones_finetuning_2, one_hot_encoding, flintstones_finetuning_3, bulgari, arthur, show, flintstones_finetuning_on_lora_pretrained, one_hot_encoding_2, flintstones_finetuning_4, bg_0201, sdxl, hearthstone, card, papercutouts, spiga, tubogas, simple, hands, prompt, no, prompter, proposer, verifier, mario, merge, openvino, int8, montresandco, dott, celeb, berfin, onnxruntime, jack, brolin, face, r32, shirts, hidden, faces, xmas, sweater, googly, eyes, cars, houses, gingerbread, toy, story, people, deep, down, barbietron, cats, movie, matrix, code, jwst, cross, section, labyrinth, dream, color, dots, abstract, upside, dpo, dare, olive, onnx, logos
stable: diffusion, xl, base, 1.0, inpainting, original, 0.9, 0.1, unclip, tensorrt, endpoints, vae, anime, architecture, diffusers, paddle, safe, compvis, lowp, kiminonawa, copy, rexxliferaj, microsoft, emoji, logo, fine, tuned, wtx, app, sam, trained, on, yujiro, hanma, images, baki, fun, project, inpainting2, custom, latestscalingfactor, x4, upscaler, onnx, variants, openvino, usaken82, finetunable, checkpoint, unblocked, small, class4, class2, chest, xray, nano, jojo, adapter, onepiece, unsafe, indonesia, business, realistic, lexiaoqi, oxified, thumbs, up, 1.5, fp16, diffusion2, refiner, cat, finetuned2, chair, rhteddy, pokemon, burn, diff, abdul, infendpoint, ps, lora, fire, finetuned, especially, for, plant, cell, diagram, onnxstream, 768px, specially, structure, 512px, new, retrained, tome, without, captions, pentland, 1024x1024, onnxruntime, 5_lora_finetuned, olive, diffusion_unclip, th, e4, tok, gordon2, gordon_dec_23, gordon_dec_24
playground: 1024px, aesthetic, fp16, olive, optimized, 256px, base, 512px, webui, training, onnx
sd: turbo, vae, ft, mse, original, ema, xl, alternative, bases, pokemon, diffusers, wikiart, onepiece, diffusers4, naruto, tohoku, newhorrorfantasy_style, db, block, world, rtx, epic, space, machine, simpsons, model, fine, tune, magicbowl, tzvc, coby, updated, fintuneable, dnditem, bib, 1.5, niraj, dreambooth, elysia, haytch, jjeenn, cresencio, rommel, rose, blackpink, ram, amv, lanakul, ortel2, bram, xaikhwng, sanket, keyingwu, felix, anireal, 2d, 2.5d, 3d, photoreal, semi, real, photo, fino, pikachu, derobr, niknorf, therock, rumeme, desc, finetuned, lora, t4, clevr, scene, graph, robrew, ai, creative, hub, hdbglv, a100, moin, brenda, andres, leotrieu, source, to, target, semireal, leanne, noinit, src, depth, rsroby, hira, flax, jorocca, lil, tohokua, tohokub, miyazaki, luke, sg2im, text2im, objects_cap, nocap, nodesonly, loral, cat, jorgen, pixelart, diffusiondb, nouns, quantumis, watch, jojo, 2m_random_5k_blur_61ks, control, unsplash_5k_blur_61ks, unsplash_5k_canny, unsplash_5k_blur_17ks, text2image, hm, unsplash_10k_canny, e2e, unsplash_10k_blur_rand_ks, hillsroad, steps, asher, sg2layout, no_cap_6000, no_cap_6000_id, nsfw, johannes, zxspectrum, three, kingdoms, gesang_flowers, deepfashion, baseline, sdxl, gond, painting, ctee, mulokoziepk, liudehua, doodeco, example, style, hand, sdxl2, shirt, sdxl_text_encoder, colab, emoji, cartoon, faces, german, shepherd, kream, sketch, house, knowledge, encoder, ep6, text, freeze, unet, flintstones, 15k, cp, naive, runwayml, pororo, img, gen, nov, new, affectnet, test, man, 1e, lcm, openvino, planets, safetensor, danielle, ssd, trained, lora40with, lora10with, haerin, controlnet, mediapipe, dec, pc, baseball, pitching, fashion, products, geolora, archives, vsr, 5k, onnxruntime, geolora3, geolora3_lowlr, geolora3_, icongenie
lcm: lora, sdxl, sd, ssd, 1b, turbo, unet, juggernaut, xl, full, model, stable, diffusion, base, 1.0, rank1
SSD: 1b, anime, olive, onnx
animagine: xl, 2.0, olive, onnx, xl2
Segmind: vega, vegart, olive, onnx, fused
dalle: xl, mini, fork, demo, mega, finetuned, medium
IF: xl, ii
dreamlike: photoreal, 2.0, 1.0, diffusion, with, safecheck, anime, photoreal1, remix
waifu: diffusion, xl, openvino, tainted, journey, unsafe, lora, unofficial
juggernaut: xl, olive, onnx
Inkpunk: diffusion, unsafe, onnx
dreamshaper: xl, turbo, inpainting, olive, onnx, lcm, openvino, fp16, w8a8
controlnet: canny, sdxl, 1.0, openpose, sd, xl, depth, 16bit, zoe, mid, temporalnet, fill, circle, maboufoul, me, vidit, room, seg, uncanny, simpsons, shadow, output, shadows, 20230430_224850, interior, design, blur, example, 0.9, faid, zeed, model2, softedge, dexined, small, traffic, diffusion, new, animeline, fill50k, ray, wireframe, model
pixel: art, xl, style, character, lora, party, olive, onnx
Analog: diffusion, unsafe
AbsoluteReality_v1: 8.1, 0_diffusers, 6_diffusers
ikea: instructions, lora, sdxl, test, test1
LogoRedmond: logoloraforsdxl
newrealityxl: global, nsfw
PixArt: lcm, xl, ms, 512x512
coreml: sd_xl_turbo_1.0_fp16_6, bit, stable, diffusion, xl, base, ios, animagine, 2.0, orangemixs, anything_cn, with, refiner, talmendoxlbeta_sdxl_8, sdxlronghua_sdxl_8bit, juggernautxl_sdxl_8, counterfeitxl, analog, anything, inkpunk, dreamlike, redshift, hassanblend, fruity, mix, elldreths, lucid, atitanstrawberry, dream, og, stolendreams, gta5_artwork_diffusion, epic, healys, anime, blend, kurzgesagtish, roboetics, photoreal, protogen, trinart, hasdx, analogdream3d, classicnegative, evoart, mj4dreammix, shady, art, rpg, retro, vivid, knollingcase, seek, art_mega, openjourney, robo, merge, libreeros, grape, like, fruit, vintedois, counterfeit, 3dkx, waifu, arterosaerosatribute, chilloutmix, liberty, minisd, rev, animated, experience, ares, ayonimix, deliberate, neverending, clarity, grapefruit, rfktrs, darkdream, wondermix, sunshinemix, sunlightmix, the, allys, complex, lineart, dreamful, modernartstyle, frottage, icomix, realbiter, ez, snvhs, lazymixplus, watercolors, dalcefopainting, urpm, edgeofrealism, project, aio, vangoghdiffusion_, floralpatterns, realisticvision, lofi, lightblackphoto, beautypromix, dreamshaper, and, cyberrealistic, ghostmix, qgo, 10b, zovya, artist, tools, ghostmix_, brabeautifulrealistic_bra, modi, disneypixarcartoon_, xxmix9realistic_, lyriel_, majicmixrealistic_preview, meinamix_meina, palettized, dreamshaper_cn, epicrealism, pureevolution_cn, realisticvision_cn, bakedvae_cn, meinamix_cn, 5_cn, mymerge_cn, meinahentai__cn, majicmixrealistic__cn, westernanimation__cn, sdhk_cn, azovyarpgartisttoolsvae_cn, cyberrealistic_cn, realmoonanime_cn, yesmix_cn, toonyou, beta5pruned_cn, inkpunkdiffusion_cn, cinediffusion, vae, ft, mse_cn, palletized, realisticvisionvae_cn, a2, coreml, split, einsum, txt2img, bk, sdm, sweetmix, fp16_cn, vae_cn, selfiemix_cn, xl1.0, alpha2_sdxl_8, crystalclearxl_sdxl_8, sdxl, unetrefiner, mlmodelc, dynavisionxl7_sdxl_8bit, nightvisionxl0_sdxl_8bit, realismenginesdxl_sdxl_8bit, bluepencilxl_sdxl_8bit, epicphotogasm, zuniversal_cn, ssd, 1b_8bit, 1b, zachsemoji_8bit, starlightxlanimated_sdxl_8bit, yamersrealistic_sdxl_8
dream: dis, pix, xl, page, mann, base
pseudo: flex, base, journey
pastel: mix, anime, xl, lora, style, stylized
blue_pencil: xl
tiny: sd, mxfinetune
midjourney: xl, diffusion, test, model, mini
DucHaiten: real3d, nsfw, stylelikeme, animefurry, retro, diffusers, stylelikemevae, goldenlife, fancyxfancy
movie: poster, redmond, for, sd, xl, create, movie, images
envy: junkworld, xl, elven, architecture, reclaimed, brutalism, stylized, anime, watercolor, technobrutalist, fantasy, art, deco, shadow, minimalism, scifi, streamline, arid, modernism, liminal, floorplans, kawaii, send, noodles, mimic, pulp, horror, oil, arcane, celestial, magical, moonrise, dreamlands, speedpaint, pastel, digital, painting, precarious, primordial, awesomizer, geometric, tiny, worlds, metallic, greebles, cel, shaded, zoom, slider, architectural, flourishes, better, hires, fix, kyotopunk, ink, swirl
text: to, image, sdxl, lora, dreembooth, rashmika, dreambooth_own_, arkenbrien, encoder, tflite, sinogram, unet, dogs, kerascv_sd_diffusers_pipeline, ai, rendering, inv, cat, test, myra, inversion, model, baseball, myra_fridec8, rashmika_
anime: illust, diffusion, xl, kawai, lineart, manga, like, xian, gao, hua, mangafeng, man, feng, style, detailer, lora, sdxl, pencil, series, vol1, model, journey, babes, bigger, dreamlike, test, nouveau, lora1, lora1000, sdxl1000
deliberate: openvino
original: epicphotogasm, te, no, prior, 2400steps, 1e, character, cyclps, pooh
counterfeit: fp16, kl, f8, vae, edited
pony: diffusion, g5, soup, lora
Arcane: diffusion
mo: di, diffusion
Comic: diffusion, unsafe, onnx
redshift: diffusion, unsafe
linkedin: diffusion
bg: visualnovel, dream, irl, model
Ghibli: diffusion, neuronx, onnx
fantasy: card, diffusion, gun, scene, sword, art, background
mr: and, misses, men, little
lowpoly: game, building, cyberpunk, environment, landscape, living, room, office, town, world
anything: midjourney, mix, light, inpainting, pruned, fp16, fp32, fixed, clone, edited
Protogen_x5: 8_official_release, 3_official_release
panda: animal, zsd, heywhale
dash: waifu, diffusion, wdm
sloth: animal, diffusion
gakki: mix, young
360: diffusion, lora, sd, output, equi
sd21: e621, rising, fluentui, emoji, hearthstone, cards
toad: mario, movie, in, the
collage: diffusion
dress: style
logo: diffusion, checkpoint, lora, test2, real, world, world_, redmond, 5v, logo, for, liberteredmond, sd, world_test
random: animals, birds, image, qwe
ControlNet: models, for, core, ml, shadows
prompt: free, diffusion
product: design, ads
kandinsky: decoder, inpaint, prior, controlnet, depth
minecraft: skin, generator, log, textures, preview
lego: minifig, xl, brickheadz, dreambooth, sdxl
KO: stable, diffusion, disney, anything
realistic: vision, skin, style, vi, stock, photo, vae, inpaint, inpainting
c: coinmaker
aether: ghost, lora, for, sdxl, glitch, green, cloud, fire, bubbles, foam, pixel, aqua
epiCRealism: natural_sin_rc1_vae, onnx
dreambooth: mritunjay, test1, avatar, vishu, friendly, otter, dog, keras, dogs, unet, to, kerascv_sd_diffusers_pipeline, piranesi, pug, ace, sd2.1, base, ngandrew, billua, groot, galaxy, mergers, seymour, cat, mandelbulb, markhor, bored, ape, fast, new, text, encoder, test, starbucks, lora, no, pp, if, sd, debug, fashion, prior, shi, self, bg, shohei, 28epochs, sayantan, lamp, car, cody, bb, exp2, exp3, duck, fancy_boot, red_cartoon, lego, ayan, fuchsia, lightgreen, balloon, bear, lawn2, car_fog, road, sidewalk, lawn, dog6, lik, cup, project, tetraneo, slag, tetrabreakwater, tetrashapebreakwater, tetrapodbreakwater, sks, breakwater, tetraoneo, breakwater2, rank64breakwater, ppl, truck, lq, hf, control, 16b, jeep, myra, toy, example
crystal: clear, xl, cauldron, tes, olive, onnx
pe: anime, background, landscapes, style, neon, uv, diffusion, balloon, caricature, toonland, sandsculpter, sign, snow, sculpture, ice, carpet, rug, pencil, drawing, high, contrast, shitty, medieval, paintings, fanart, spectral, old, school, cartoon, colorportrait, cat, dog, lofi, hiphop, girl, concept, habsburg, big, chin, holding, mugshot, funko, pop, courtroomsketch
cute: animals, style, kitties, cartoon, illustration, dog, xzg
LaVIT: 7b
japanese: stable, diffusion, xl
2K: vae
LCM: dreamshaper, openvino, onnx, int8, lora, sdxl
ch: art
doctor: diffusion, stylized, silhouette, photography, xl, lora, lora1, tarot, card, crafter, controllable, vector, art, claymation, style, xray, n64, 218mb, 7mb, versions, cosmicdisco, toy, negative
scandinavian: style
spiderman: xzg
my: pet, dog, ttt, panda, korean, stable, diffusion, anything, girl, model, wife, testing, face, cute, xzg, bike, rsg, bear, nxt, cat, meow, sbs, and, jxl, avatars, by, lora, sneaker, thanos, bag, csd, xyz, xzh, xzk, hsq, axr, xgz, plushie, jdc, qaz, car, efk, backpack, model2, luffy, friend, training, projectvar, dogvar, var, mno, wolfsto, dogert, dogrtg, chessavk, jkl, ert, dreambooth, dogxgz, vij, rsu, white, horse, xzc, character, xzp, rabbit, abc, ai, project, tiger, on, indian, road, czx, xzl, cats, new, 1st, generative, bright, butterflies, exp, robot, parot, sxh, thar, xyz1, fortuner, hungry, lion, roses, puppys, esp, xzr, mickey, dfg, animal, picture, german, shepard, avd, dragon, fruit, picturee, with, smiling, ms, dhoni, bicycle, mvp, pt, own, sgls, bird, xnr, red, hrk, ahv, chair, sdxl, steps, garden, flowers, dogxzg, afx, beautiful, beach, iwe, xyg, zxy, robots, cvb, zxc, mouse, rem, mka, parrot, text, to, image, model_6, eaak, uig, racecar, ferrarri, majestic, rocket, house, birds, agriculture, anj, controlnet, test1, fav, kvh, actress, favourite, hero, pics, gcz, photography, akw, gaming, jld, teddy, cricketer, game, space, movies, cricket, player, shepherd, nts, bunny, ars, cockteil, bid, peacock, asd, maths, alb, sunglasses, eagle, fzw, rpy, favorite, ssd, hotel, lord, ajy, aak, kri, hhr, tut, dogxyz, elephant, bulb, shih, tzu, monkey, ksv, xza, koala, smg, wolf, ssa, xcv, cat2, duck4, xzy, nrg, kml, xxg, rsd, bfs, collection, rac, wlf, zkc, jen, sls, bhoot, broccoli, sas, drag, flower, aze, qwe, kitten, wza, mod, deer, smi, azm, apple, ard, photo, anyaf, images, nxu, toy, virat, kohli, rkg, hpz, lcm, xmt
sd15: dpo, muppet, blip, fluentui, emoji, jojo, stone, ocean, arthur, captions, caricature, portraits, simpsons, disneypixar, mix, fp16, bender, lora, dreambooth
linoy: lora, repeats
poli: multiplier, face, repeats, exp, cap, xl, finally, no, prior, rank, standard, token, only, pivot, tokens, caps, snr, investigation, peft, test, reverse, tok, short, captioned
sync: e6a4302b, f561, 42f9, b352, 3ea46fd3a499, u1, aaa177c2, 54ed, d84a7bb8c18e, f40a07b6, 9eec, 442b, b01d, 815a40271c09, e1, d84776c9, 49e7, 4c81, b3a3, ab77c2c1feef, 8409a645, 98d7, a3dd, 8a97ca2f1b66
ae: sdxl, gf, animation, sd15
lora: trained, dreambooth, sample, dog, httr, kimono_sd, ruchelle, dragon, ball, wufan, sola, peace, sign, cube, test, text, encoder, lora, target, panorama, starbucks, xl, potato, head, keramer, face, xl_dog, xl_lhand, xl_350, xl_400_prior, jugg, model, xl_demo, person, irasuto, mogan, shohei, gsx, colab, sd, with, prior, loss, other, colab_agsts_cat, stp16, hmth, stp17, hya13, stp18, stp19, stp20, stp21, cory, anime_colab, kaggle, p100, colab2, mirit, 2e, colab_2, 1e, stp22, stp23, stp24, stp25, stpvfinaltune1.0, monster_toy, 0.0001, stpjdepp1, stpjdepp2, stpcsmith, stpcsmith2, dinesh, dinesh2, woman, cheeto, 5e, cam, colab_potatohead, colab_gieskanne, vjg1, cat, shiny, sneaker, lego, tiles, 3d, icon, ggg, stp, thumper, hermes, mini, kelly, 5k, steps, linoy, graffiti, none, licar2000, withblipbehind, rev, colab3, 3d_icons, monkey, car, dr, 5c, standing, colab_gieskanne_500it_lr_1e, flag, micky, ktiger, chcheetah, cwcb, mcd, dura, amul, airpods, yoshi, colab_toffee, sneaker2, monkey2, pkt, owl, stp26, stp27, deafult, xl_with_text_encoder, xl_with_text_encoder_no_mixed_precision, erza, gerard, newstate, me, slm1, slm2, slm3, sdxl, folder, kuroshiba, raizo, mll, enzofernan, ef, jewel2, necklace, finesse, dongho, linoy_face, 1.0, prodigy, vcleavage, dadu, colab_pagnut, vycz, dongho_1, colab_wrong_db, thumbs, up, pw, 0.5, uttam, ug2146, colab_911_carrera_s, colab_cayenne9yaai1, sidhum, take, two, fred, loopy, tatttoo, ssd, fred1, fred2, 1b, doll, doll_5, yuan, bicycle, plu, plu2, plu3, plu4, plu5, janeanderson, janeanderson_long, hub, shoes, new, noahsanchez_long, noahsanchez_rvxl_long, noahsanchez_baservsamples_long, rachelmcpherson_baservsamples_long, rachelmcpherson_r_novae_long, noahsanchez_r_novae_long, robertjones_r_novae_long, raw_photo, molti, molti2, truck, tetraneo, train, jsdxl, new_25, xl_rem, waterpainting, xl_me, 3drendering, drawing, watercolor, caricature, plushie, njstyle, notion, illustration, eighties, saina, bag, orange, sks, fbb, tok, garment, fiona, highrise, richard, monet, sd1.5, dog2, uzaki, japan, steffi, betty, bettyfullbody
SDXL: lora, slider, concerned, jojoso_style, simpstyle, dreambooth, hrsfc, lofigirl, olive, optimized, stickersheet, mademory, caricaturized, vintagemagstyle, benderbot, pringlestube, jojosostyle, unstable, diffusers, divinity, machine, xmasize, yellow, dreamscape, looking, at, viewer, huge, anime, eyes, psychedelic, trip, extreme, sports, spooky, ghosts, elf, orc, extremely, detailed, excited, casting, spell, photobombing, koala, bear, fancy, catwalk, snowingsnow, covered, beanie, ski, mask, 90s, admiration, courage, surprised, laughing, person, wearing, headphones, dancing, sitcom, star, holding, gun, the, camera, impressed, action, shot, dark, skinned, plastic, toon, pixar, style, ps1, graphics, shocked, superhero, mohawk, sunglasses, lizardperson, rich, clown, ninja, turtle, fit, upside, down, pigtails, makeup, smartintelligent, treant, referree, pirate, gingerbread, house, water, elemental, fire, ferocious, dragon, creativity, santa, evil, drunk, yelling, snowman, whos, in, whoville, photo, of, grinch, bar, holiday, festivus, team, trending, on, artstation, pixel, art, sonic, hedgehog, doge, from, dogecoin, latin, asian, eye, catching, complex, intricate, laser, background, cosplay, outfit, shady, dreadlocks, curly, hair, studio, ghibli, intimidating, masterpiece, hot, underwater, flood, wife, beater, shirt, love, alpaca, photobomb, asleep, angelic, demon, cartoon, cross, eyed, sexy, raw, hoodie, winner, perfect, deep, sleep, eating, spaghetti, pinhead, phone, stage, bus, an, airplane, glassjar, popping, shiny, judgemental, look, mischievious, grin, maniacal, laughter, distinct, focus, bloom, shader, cel, shaded, colorful, low, poly, count, mistletoe, mercenaries, fireworks, actually, dog, trenchcoat, van, gogh, overenthusiastic, passionate, wood, elfdrow, moon, christmas, cinematic, werewolf, super, mario, view, above, sharp, cosmic, horror, octane, render, by, artgerm, and, greg, rutkowski, alphonse, mucha, vaporwave, aesthetic, painting, persistence, memory, salvador, dali, high, contrast, puffed, out, cheeks, heavy, overcoat, behind, epic, composition, mad, scientist, paper, mache, wario, bright, brilliant, photoshopped, blue, color, gold, snes, screenshot, soulful, radiant, green, glowing, white, final, boss, took, too, many, drugs, balenciaga, gucci, funko, pop, big, head, mode, gigantic, small, body, sfx, step, futuristic, logo, design, burning, red
pokemon: stable, diffusion, lora, small, test, lora4, lora15, lora_sd2.1, lora2, xformer, sophia, text_to_image_lora_1
jit: traced, waifu, diffusion, unet, stable
doodad: embedding, layer, ckpt
robo: diffusion, base
elden: ring, diffusion, unsafe
icon: diffusion, ckpt, lab, test, ai
long: prompt, weighting, pipeline, legs, diffusion
SD: cloned, on, aditi, basantani, silicon, joepenna, people, with, controlnet, lora, merge, test, dog, test5, test6, jennifer, test1, jenniger, test3, test2
Cyberpunk: anime, diffusion, diffusion_with_support_for_gen, imp_characters, onnx
Stable: diffusion, pokemon, ja, en, zh, finetuned, models, btd6, burn, 5_fp16_cleaned, cats, generator
Lyoko: diffusion
classic: anim, diffusion
Tron: legacy, diffusion
Taiyi: stable, diffusion, 1b, chinese, en, anime, sd, pokemon, lora, zh
model: test, trained, with, me, mixing, stash, res, lora, sd15, dreambooth, chair, 2.0, 27e746b1, 469a, 959f, 668a19a8135c, sd, priorp, lowlr, unet, regnam2, regnam3, lr5e, lr2e, new, lr3e, hf, ab, oct, ckpt, multi, flowers
Dungeons: and, diffusion, unsafe
zelda: botw, stable, diffusion, the, cat
netsvetaev: free, black
doohickey: mega
vulcan: diffusion
Anime: merged, tarot, card, art, style
Complex: lineart, unsafe
Double: exposure, diffusion, embedding
EimisAnimeDiffusion_1: 0v
character: lucy, edr, design
artstation: diffusion
noggles: fastdb, sq, 5400fp16, 30percent, best
magic: diffusion, cube, website, sd, model, lora
emoji: diffusion, stable, db, model, finetuned, lora, test, dreambooth, trained, xl
AltDiffusion: m9
AltCLIP: m9
mustafa: kemal, ataturk, dreamshaper, fine, tune
rust: stable, diffusion
hitokomoru: diffusion
food: crit, sd1, 768px, momos, style
abstract: anim, spritesheets, nature, pattern
zombie: vector, style
sofia: roses, 5e
StableDiffusion: releases, 2.1_512_einsum_img2img
hyc: sd, 2e, man, ddim, sd15
zrn: sd, 1e, woman, ddim, 2e, sd15
ira: olympus
noah: titan, 8e, bradley, style
flat: design, icons, 2d, animerge
lineart: x1, model
pai: diffusion, food, large, zh, general, symbol, heywhale, xlarge, controlnet, canny, depth, artist, lora, poem, anime, 25d
sd2: simpsons, blip, cartoon, dreambooth, claymationxmas, lora, inpainting, sentinel, rgb, flintstones, model, twoobject
style: eternos, enhancer, xl, lora
knollingcase: embeddings, sd
hulk: style
azzy: og
photorealistic: fuen, slider, sdxl, lora
messi: ronaldo, dreambooth
woolitize: 768sd1
v2: object, 16img, 2000training, base, worker, class, line, enhance, site, insulator
organic: mind
aimersd2: hopefinal
p: ai, nter_
monet: style, test, 2steps, 3000steps, realsize, 1000steps, 500steps, post, 5000steps
colorjizz: 512px, 768px
black: cat, sheriff, fortuner, ppg, to, white, colour
craig: wazowski, style, mullins
froggy: style
rpg: clone, portrait, generator
autotrain: dreambooth, marsupilami, victormautotraindreambooth, fs8jgubryx, consequen, wew6km47et, goodhueschairdemo, kprjbj8d95, jayefam, xtvogkx3rd, jc0q, lzj1, y7fb, adv, 15sept, poliphoto, repeats, steps, rank128, with, prior
SD2: 1_avatar, 1_pokemon2dsugimori, 1_pokemon3d, avrora, lora
any: ely, wd, ira, olympus, noah, titan, pastel
cool: japan, diffusion, for, learning, beta
custom: dreambooth1, diffusion, cat, wooden, pot, controlnet, kaggle, epoch10, model
seek: art_mega, unsafe
vibes: beta, checkpoint
clay: icon, animation
test: photoreel, kerascv_sd_diffusers_pipeline, portal, training, ids, lora, joan, mitchell, 200steps, cleaned, dog, cat, rabbit, crystal, diffusion, repo, model, myface, upload, besk, pubg, is, italian, style, victoria, with, reals, ddpo, tag
ai: protest, anime, avatar, generator, illustration, nft, generater
NoAI: diffusion, variety
wedadams: pyros, bj, bkdbj, pow, cow, ckpt, sxd
cburnett: pieces, attempt, helmet, concept
clayitization: sd1, 768px, sd2
karlo: alpha, image, variations
me: dl, assignment, my, shadow, poli, peft, tok, only, multiplier, no, prior, short, cap, captioned, repeats
ccorgi: dog
banchan: anything, protogen, lora
riffusion: rage, jamiroquai, tequila, dragonfriction, model, db, finetune, musiccaps
happy: textures, model, happytex, diffusion
wooditize: sd2, 768px, sd1
SD15: vinagestyle, illusiondiffusionpattern, lora, pumpkinhead
mitsua: diffusion, cc0, one
wriggly: extra, gum, artstyle, waifudiffusion, furry, ponydiffusion
saqib: sarahkhan, t350, u4000, pm, t840, u1200, dec, u2000, feb, t1400, photoreal, t600, u3000, t900
white: walker, style, horse, shirt, lightblue, necktie, lora, meinamix
sci: fi, landscape, environments
rio: cat, sd
plushies: pt
cat: toy, genshin, face, blip, datasets, lora, ai, adv, xzg, xgz, lora2, ppt, model
the: owl, house, diffusion, crystal, exarch, ally, cat, csd, talos, project, barn, xzj, promised, neverland, emma, sdxl, truality, engine, ray, norman, sd15, mighty, tiger
Ira: olympus
diffusion: model, tflite, cloody
vintedois: diffusion
2: sd, modern, buildings, style, md, 5dguofeng, 5dset_diffusers, 5dset_new1a25d_ffver, kwi
rick: and, morty, ramrick, character, roll, style, rsanchez, steps, inputs
lumine: db, old
pochita: plushie
trpfrog: diffusion, icons
shoebill: bird, fnavales
stargate: diffusion, sg1
Sygil: diffusion, muse
mann: e_rev, e_4_rev, base, large, new, e_5, merge, artistic, barbie, concept, dark, fantasy, revised, pixel, art, bitmap, comics, sketches, e_5.4
mf: doomfusion
paint: journey
stuart: minion, little
Protogen_x3: 4_official_release, unsafe
jason: art, dreambooth
epic: diffusion, controlnet, canny, unsafe
asmagalally: with, protogen
mpid: bkdbj, hassanblend, better, train, main, hard800, main2500, last, version, uber
bird: danphe
avatar: jsjessie, jsjessy, low, facetuned, generator, fantasy, high, poly, creator
fastbooth: jsjessy
huggingface: jsjessy, with, env
fusion: final, graphic
instance: name
lunar: surface, radiance
dashdash: toy, heywhale, cat, golf, rabit, wonderland
sks: jessy, arzu, man, dog, model, hardik
Avatar: gen, ai
Evt_V4: preview
paper: mario, thousand, year, door, map, model, suki
space: nebulas, nebula, tour
stablediffusion1: kingperion
video: stable, diffusion, installation
https: huggingface, co, m4gnett, zeipher, f222, mistermango24, margret, stalizburg, zp92, dreambooth, lora, library, test, spaces, antonellaavad, training, ui, iyashi, haku, naruto
kat: wd, 1.4, beta1, beta2, beta3, at3
hassan: fathy, diffusion, test
AbyssOrangeMix2: hf, hard, vae, swapped, edited
small: stable, diffusion, sd, th, e5, g1, g16, bs16
coco: cat, heywhale, clip
animation: mr, black, heywhale, 25d, sd15
fforiver: river, mdj
kate: wd, 1.4, beta1, at3, greenaway, style
alex: one, line, art, andreev, style, gross, pardee, model
DreamShaper: 3.3, fp16, xl, xl1.0
Anything: preservation, edited, ink
fluffalpaca: llama
fgreeneruins: ruins, mdj
ac: qual
landscape: ocean, rendering, style
MF: konosuba, ascendanceofabookworm, bofuri, base, eminenceinshadow
ds: lora, test
testing: rolls, royce, steps, test2
duskfall: virtual, 3d, diffusion, digital, fantasy, crew, visual, art, style
a: man, is, surfing, photo, of, simbatheog, zovya, photoreal, zovyarpgartistvae, zovyarpgvae, zovyaremix, beautiful, photograph, tfg, dog, sitting, in, beach, with, balls, black, cat, human, face, named, virat, kohli, horse, taj, sjh, candle
output: results, fashion
t: shirt, prin, diffusion
xiaolxl: guofeng
toooajk: yagurumagiku, dreambooth
text2image: steatosis, 512x512, abwqr
disney: ps, pixal, cartoon, pixar
doodling: ai, ai2
ani: backgrounds, pineapple
project: unreal, engin
this: youtuber, does, not, exist, rug
carrot: commercial
photography: and, landscapes, lora
digital: vivid, memories, human, doodle, cartoon, worstimever, artstyle, 218mb, xl, lora
female: it, engineer, style
pepe: diffuser, image, rcook, test
dreambox: mix
art: of, wave, diffusion, xl, 0.9, khk, olive, onnx
openjourney: lora, kan, unsafe
blue: back, pack
Counterfeit: vae, swapped, unsafe, _fp16_cleaned
Foto: assisted, diffusion, fad_
isometric: dreams, sd, cutaway
VOXO: vtuber, diffusers
fine: tuned, 30designs
SKINCON: lora, all, tags, photo, caption, disease
dilbert: comic, model, 1_2k, 2_2k, dreambooth
lora_leadership: role
rev: animated, anim, eol
picasso: diffusion, style
egbert: 2x, source, bilinear, imagemagick, scale2x
crying: baby, woman
NeverEnding: dream, dream2, dream_fp16_cleaned
X: mix, ray, lora
first: avartar
graphic: art, novel, illustration
mem: jasper, writer, testing, model
lily: phoebe
runwayml: stable, diffusion, ov, fp32
hubble: diffusion
girl: zty, yy, zty2, in, white, office, attire
hkdb: hmr, sdft, rs, rvo, wamd
0: 1unstablecreatures
untitled: replicant
fast: dreambooth, nijika, efmediastyle, 3d, class
man: junwym
fashion: model, crops, prior, realistic_vision_, sdxl, lora, training, with, 256x256
wavymulder: portraitplus, ov, analog, diffusion
stabilityai: stable, diffusion, base, ov
andite: anything, ov, finetunes, backup
arabic: amera, home, decoration, model, anime, building
chebakia: diffusion
luna: diffusion
jiaxin: dreambooth, lora, xlt2, xlt3
diffusers: generation, text, box, inpainting
iraqi: cafes, marshes
kopper: kreations, custom, stable, diffusion, style, photos, vv, sd, model, object, copper, heart
sb: aneld, my
805Na: diffusers, kerascv_sd_diffusers_pipeline
robot: jones, style
anythinv3: vae, handler
uv: flower, map, lora, sdxl, r32, lr, 4e7
sketch: of, an, animal, model, style, xl, lora
veka1: style
gmater: poster, style, ch, cartoon, ad, lora
tattoo: model, test, diffusion
rafadan: hayri
chessman: sd2.1, lora
copper: analog, sd1.5, sd, version2
Dreambooth: avatar, punko, trained, xl, colab
fill: circle, controlnet
aesthetic: controlnet, controlnet_for_webui
wand: magic2, duckstyle2, color3
Arabic: clip, vit, base, patch32, patch16, bert, lit
Useless: yuzulemontea, mix, whitemixs, triphaze, sukiyakimix, 7pa, something_2
canny: coyo1m, test
adv: ai, custom, lisa, lsa, portrait
path: to, save, model, model_3, model_, pathimages, diffusion, priorp, lowlr, unet, table, model2, model3, model4, model5, dreambooth, prior, dog, multi
slant: lora, sag, sag15, all, axial
night: diffusion, sky, yozora, sty
studio: ghibli, style, howl
zephyrs: waifu, diffusion
sd_martin_valen: model, 2_400, 2_400_demo, 2_400_demo_2
MIX: pro, pro_fp16_cleaned
eanovnty: s2300, s2900, s1500, smlvnty, s1700, esmlvnty, s8000, full, s9000
gustave: dore, dantes, inferno, style
abyssorangemix2: hard, hardcore
george: green, illustrations, condo, style
wonder: woman, anime
dog: pose, example, demo, test, lora, model, lower_lr, hack, sd2, pt, don, sdxl, dreambooth, images, in, different, backgrounds, xl, img, was, xzg, ppf, ppt, 1.4
top: down, token
db: simpsons, asim, style, lora, xl, sdxl, whitebg, product, photography, ext, cp, hugger, dog, class, bear_plushie, class2, antidotes, atd2, atd, candle, trained, luana, 2k
chillout: mix, appfact, app, factory
dark: sushi, mix, 25d, appfactory, fantasy, gathering, yayoi, hozuki, sdxl
unidiffuser: diffusers
sd_aiconos: model, 2_400, 2_400_sush
all: animated, babes, in, kzkhs, lora
cinnamon: mix
mart: forge0
clip: bert, lit, two, stages, mix
three: delicacy, wonto, kingdoms, stable, diffusion
pcam: tumor, text, normal
crc: tumor, text, normal
testman: lora
ft: models, sd15, portrait, human, human_largebath, human_face, simpleinstance, iom, iom_person, class, instance, instance2
A: himawari, others, rainier
naruto: blip, captions, mkh
map: diffuser, training
mymjaw: sd15, model2, sd
iam: dosmix, afgchillmix, wateriro
himanshu: sb
nana: portrait, model
perfect: deli, appfact, world, world111
CELL: e_2_opencell_2560, e_2_hpa_480, e_2_hpa_finetuned_480, e_2_hpa_2560, e_2_hpa_640, e_2_opencell_640, e_2_hpa_1280, e_2_opencell_1280, e_2_opencell_480, e_2_hpa_finetuned_640, e_2_hpa_finetuned_2560, e_2_hpa_finetuned_1280
meina: appfactory, hentai
Nabylon: fp16, inpainting
portraitplus: unsafe
hc: anything, vae, chilloutmixnickpt
pastelmix: better, vae, fp16, fp32
SD_1: 4_simpson_tune_lora, 4_simpson_tune_, 4_simpson_tune_lora_, 4_simpson_pokemon_tune_
Poltergeist: mix, illustration
joan: mitchell, 5000steps, 3000steps, cleaned, 4000steps
Arc: diffusion
another: lora, dog, test
nature: and, animals, scr, gsh
foto: assisted, diffusion
car: turn, lora, xzg
cyberpunk: style, new, anime
hassaku: hentai, model
civitai: light, shadow, lora
ddpo: aesthetic, alignment, compressibility, incompressibility
uber: realistic, merge, porn
fantasticmix2: 5d_test, 5d_
LoRA: merged, coreml, models, lcm, sdxl
animal: image, generation, xzg
malware: dream
di: ffusion, ai, beta512, base, alpha
architecture: tuned, model
cartoon: character, style, blip, captions, model, lora
musinsaigo: 1.0, 2.0
babes: backward, mix
sam: controlnet, fresh, spratt, style
city: lora
yamanaka: ino, realistic
photo: of, walidlibyaly, person, walidlibyalyy, sks, hp
K: main, main2.1
abyssorangemix3: fp16, popupparade
konstantindreambooth: dl9
CuriousMerge2: 5d_e, 5d_
web: model, y2k
van: gogh, style, diffusion, test, stable
zai: model, model2
gtl: elephant, ext, test2
bias: mitigation, t1, ceo, t2, executive
max: 1e, 1.5, 2e
d: designer2
SoapMix2: 5d_
drood: icbinp, disney, pixar, ghostmix
brie: larson
majicMIX: realistic
ldm3d: 4c, pano
kilira: cooper
andy: raconte
unlimited: replicant
Aurora: by_consistent_factor
trained: model, with, murazzi, photos, sd, truck
female_hanbok_1e: 4_ckpt, 7_ckpt, 7_ckpt_icb
ivan: animated, bilibin, style
ru: vision, lora, trained, xl
russian: vision, beta, universal
niji: lora, diffusion, xl, base, 1.0
SDVN1: real_, real_origin
everyjourney: sdxl, 0.9, finetuned, xl
flarex: diffusion3, ddiffusion
lol: diffusions
magicbrush: paper, jul7
kangaroo: training, part
amazing: logos, lora
bk: sdm, base, small, tiny, 2m, vpred
person: thumbs, up, lora, no, cap, plain, finetuned, travel
hellopure_v2: 24beta
sabbur: protogenx3
polla_mix_2: 3d, 4d, 5d
finetune: stable, diffusion, planogram, lora, data3, nocrop, sd2, data4, sd, data5, data7, data6, dreambooth, wo, prior, preservation, abdul1
jordan: generator
clock: tower
orange: diffuser, juice, ad
peach: diffuser, diffusion
animefull: latest, ckpt
potato: diffusion, diffuser, diffusions
Tora: nijifurry, lora, xl
tomato: diffusion, diffuser, model
textual_inversion_mpchar: r4, r100, obj
strawberry: diffusion
water: diffusion, bottle
face: sketch, model, db, robotics, helper, sdxl, lora
DucHaitenAIart: beta
FFusionXL: sdxl, lora, island, generator, potion, art, engine, base
perfectdeliberate: ee
urpm: eevee
childrens: stories, semi, real, toon, anime
stacco: ikea, ai, interiork
epicrealism: updat, epinikio, natural, sin, fused, sd_base_tightjeans__w1.0
picture: diffusion, of, bmw
leosams: instant, phot, xl, olive, onnx
Cetus: mix_whalefall_fp16_cleaned, mix__fp16_cleaned, mixxx
DBSD: 1.5, vectors, lr, 5e
green: diffusion, clip, inpaint
hermitage: xl, olive, onnx
portrait: finetuned, realistic, sd15, sdxl, sd1, realisticman, realfantasy, realbeauty
t2i: adapter, sdxl, segmentation, multi, style, vietnam, pictures, 1k, 2k
trdne: simple, prompt, smol
out: dir
RunDiffusion: xl, beta, fx, photorealistic
fuwafuwamix: edited
IconsRedmond: iconsloraforsdxl
REV: mix
beautiful: realistic, asians, asian, roses
pet: dogs, amb, cat, abc, xzy, dog, xzg, kst
german: shepherd, dog
textual_inversion_cat: toytest08082049, toytest08082136
kag: sd, model, lora
vroid: diffusion, test, unconditional
xzg: cat, nissan, gtr
KIDS: illustration, lsh
LineAniRedmond: linearmangasdxl
beautifulv6: 32fp, with, ema
ponteleich: 3500s
village: output, 10k, custom, masks, text, encoder
xl: 1.0, more, art, full, xl, real, enhancer
piven: white, model, nitrosocke
chilloutmix: ni, prune
analog: diffusion111, nast3
majicmix: lux111
ardic: ai, sd, fdb
image: gen, sd, 1.5, only, logo, output
stained: glass, style, sdxl, portrait
samantharuth: sdxl, db
dogeai: openjourney
cyber: ui, aesthetic, room, graphic, shaman, background, tech
skeleton: toy, kris
alien: god, style, lora, sdxl
psychedelic: noir
color: fashion, palette
dave: quiggle, style, mckean
retro: rocket, magazine
ps1: graphics, sdxl
PNDM: classic, art, art2
rachit: trained, xl, colab, lora, sdxl, db, cosine
weird: fashion, show, outfits, sdxl, lora
street: tones, art
absolute: reality, 1.81, 1.6525, 1.0
jensen: lora, trained, sdxl, sdxl_1000, sdxl_lr_e
xsarchitectural: inte
neon: environments, night
arc: diffusion, 1.2, 1.2.1, 1.3, dev
heman: toy, lora, trained, sdxl
ash: networks, bird, is, professor, oak, good, bad
primitive0: diffuser
maow: maow, machine
realcartoon: pixar, xl, olive, onnx
jeff: milton, model, face, dreambooth, test
anna: asti, maria, garthwaite, style
Hassaku: fp16, xl
real: cartoon, realist, 3d, dosmix2, faces, women, ai, amateur, nudes
hcm: benthanh, market, ducba, cathedral
tara: sutaria
copax: sdxl, timelessxl, sdxl10
wildlife: tiger, beauty
peacock: xmj
protovision: xl
Walter: man, xl, 1.0, class, optimized, person, dreambooth
Dark: sushi, 2.5d, realism, lora
christopher: balaskas, style, ryan, mckenney
daniel: arsham, style
director: agnes, varda, style, akira, kurosawa, andrei, zvyagintsev, bong, joon, ho, christopher, nolan, darren, aronofsky, david, fincher, lynch, emir, kusturica, gaspar, noe, jean, pierre, jeunet, krzysztof, kieslowski, lars, von, trier, martin, scorsese, nicolas, winding, refn, park, chan, wook, pedro, almodovar, quentin, tarantino, ridley, scott, sergei, eisenstein, sofia, coppola, stanley, kubrick, terrence, malick, tim, burton, wes, anderson, wong, kar, wai, yorgos, lanthimos, zhang, yimou
dixit: card, generator
erik: johansson, style, madigan, heck
james: christensen, style, jean, eads, turrell
jan: brueghel, style, svankmajer, van, eyck, goyen
jean: baptiste, camille, corot, style, monge, simeon, chardin, metzinger, michel, basquiat
john: albert, bauer, style, berkey, blanche, constable, everett, millais, harris, james, audubon, kenn, mortensen, martin, singer, sargent, singleton, copley, william, waterhouse, smith
josh: agle, style, kirby
made: of, iridescent, foil, in, abyss, nat, sdxl, reg, lora, shiggy, riko, irumyuui
mark: catesby, style, ryden
maurice: de, vlaminck, style, prendergast
mike: mignola, style
paul: gustav, fischer, style, laffoley, signac
peter: doig, style, paul, rubens
photographer: elena, helfrecht, style, flora, borsi, maren, klemp, martin, kimbell, reuben, wu
pierre: auguste, renoir, style, bonnard
punk: collage, models
ralph: bakshi, style, steadman
richard: corben, style, dadd, hescox, scarry
robert: adams, style, crumb, rauschenberg
roger: ballen, style, deakins
surreal: collage, harmony, plate
thomas: cole, style, kinkade, moran, schaller
victor: brauner, style, moscoso
willem: haenraets, style, van, aelst
william: langson, lathrop, style, mctaggart, merritt, chase
StyleGen: loopster, dl, test
LEOSAMs: helloworld, grain2, sdxl, base, model
dl: test, dog
s: grocery, data
snapp: data, grocery
OldFish_v1: 1mix_hello, 1_personal_hdmix, 1_diffusers_recover
huggy: lora, sdxl
custom_diffusion: noprior
ToonYou: jp
gentzy: lora
by: sunrise, muji, feng, zikai
monster: cars, sdxl, lora, toy
cartoonify: 25d, sd15, potrait, sd1
animationart: sd15, realistic, sd, sdxl
medical: illustration, heart, mvdream, lora
ImMagician: fantasy
wafer: thnn, complex, prompts, gudeoungi
bluepencil: xl5
lob: realvisxl, juggernaut, xl
SouderRocketLauncherNetCombined: sd1, inversion, xl
bellagio: ai, t2i, ben, thanh, market, vietnam, pictures, concat, concat1
tradfusion: e4, diffusers, e5, model, training, files
dripped: out, xl
ryo: takemasa
LCM_Dreamshaper_v7: openvino
aki: sd, sdxl
waqasramzan: sdxl
aoki: sd, sdxl
3d: humanoid, redmond, 5v, 3d, render, style, for, liberte, sd, 1v, freedom, icon, sdxl, lora
WalterNgo: face, xl, dreambooth, 4k, vn, pictures, 2k
Dreamshaper: xl, olive, optimized, fast
incremental: test
groow: new, tokens
yamermix: vae
StingerMix: pruned, sd1.5, full
sidebangs: earring, anime, woman, lora, meinamix, stingermix, larosbell3d
lion: running, king, xzg
ASAP: as_soon_eastasian_peeps, neuro_dive, series, as_soon_eastasian_peeps_re
dreamshaper_8: t_qo1dxvwt3ktecwuf, t_wcxttihlwiqlsc
Made: in, abyss, marulk, loraxl, binary, star, falling, into, darkness, aki
zhima: jp
lametta: fp16, conv, beastboost, 2ch
taesd: openvino, onnx
MeinaMix: full, sd1.5, pruned
Jibaku: shonen, hanako, kun, tsukasa, sdxl, lora, yashiro, nene
yeah: bouy, blend
tiger: gam
epicphotogasm: conv
lds: w121, w071, w200, w100, w227, inpaint, w173, xl, w051
wild: life, animal, tiger, p1x
elephant: gjp
Deliberate: onnx
ColorfulSSD: 1b_
dogs: was, are, cats, baseline
cathead: sd1
sce_2: sites_imgs, 42_steps, 6200_lr, 3e6, 1e5_regularization, none_model, base_diffuser, 4200_lr, 5e6_regularization
magi: the, labyrinth, of, magic, aladdin, sdxl, sd15
StudioGhibli: redmond
rahul: gandhi, lora
emojis: sd21, sd14, sd13
sd_base: db, selfies30, 1e, priorp, full, selfies4, gc, selfies1, 2e, faces4, 2burn, real13, 3e, angel, genbg10, poly, linear
dogSimilarToTangyuan: lora
treasure: planet, ships, general, procyon
loras: pack
NightVision_XL: olive, onnx
hp: lovecraft, style, xl
open: diffusion
albedobase: xl
stickers: redmond, version, stickers, lora, for, sd, freedom
Controlnet: segmentation, landmark
coloringbook: redmond, 5v, coloring, book, lora, for, liberteredmond, sd, 1v, freedomredmond
tshirtdesignredmond: 5v, shirt, design, lora, for, liberteredmond, sd, 1v, freedomredmond
minimalist: style
studioghibli: redmond, 5v, studio, ghibli, lora, for, liberteredmond, sd, 1v, freedom
italian: style, new, model, updated
origami: style, sdxl, lora
v1: pruned
melaura: merge
testwoosuk: aznmke
ZHMix: dramatic
dynavision: xl, olive, onnx
colossus: project, xl, sfwns
HaveAll: diffusers, olive, onnx
CS245: fine, tunedsd100, tunedsd150_708, tunedsd1000_708, tunedsd0_100_14122, tunedsd100_400_14122, tunedsd400_700_14122, tunedsd700_1000_14122, tunedsd1000_1300_14122, tunedsd1300_1600_14122, tunedsd1600_2000_14122, tunedsd2000_2400_14122, tunedsd2400_2800_14122, tunedsd2800_3200_14122, tunedsd3200_3600_14122, tunedsd3600_4000_14122, tunedsd4000_4400_14122, tunedsd4400_4800_14122, tunedsd4800_5200_14122, tunedsd5200_5600_14122, tunedsd5600_6200_14122, tunedsd6200_6600_14122, tunedsd6600_7000_14122, tunedsd7000_7400_14122, tunedsd7400_7800_14122, tunedsd7800_8200_14122, tunedsd8200_8600_14122, tunedsd8600_9000_14122, tunedsd9000_9400_14122, tunedsd9400_9800_14122, tunedsd9800_10200_14122, tunedsd10200_10600_14122, tunedsd10600_11000_14122, tunedsd11000_11400_14122, tunedsd11400_11800_14122, tunedsd11800_12200_14122, tunedsd12200_12600_14122, tunedsd12600_13000_14122, tunedsd13000_13400_14122, tunedsd13400_13800_14122, tunedsd13800_14200_14122
dont: toy, with, me, miss, nagatoro, hayase, lora, sd1.5, sdxl
lnmdlsktchfsh: model
kungfu: panda, two
bedroom: model
Emotions: smile, test, defiance, nervous, happy, 1ee3
ninja: creat, create
single: passion, flower, morning_glory, petunia, frangipani, morning, glory, concept, dog
cutifiedanimecharacterdesign: variant, type, sd, sdxl
mushoku: tensei, aisha, greyrat, lora, sdxl, norn, rudeus, homecoming, arc, sd
tangyuan: dreambooth, textual, inversion
kt: baseline, s1, s2, s3, s4, ss1, ss2
output_lr1e: 6_data, 6_data_size1024, 6_data_size1024_step1000, 6_data_modify_size1024_step300, 6_data_modify_size1024_step400_zoomin, 6_data_modify_size1024_step1000_zoomin_, 6_data_modify_size1024_step1000_zoomin_textprompt, 5_data_modify_size1024_step1000_zoomin_textprompt, 5_data_modify_size1024_step1000_zoomin_textprompt_, 6_data_modify_size1024_step1000_zoomin_textprompt_
minimalistic: test, model, weights
dogs_8: img2token, regularization
kemono: jihen, nobimaru, sdxl, kabane
AAM_AnyLora_AnimeMix: lcm
polipure: repeats, steps, rank64, with, prior, rank128, no
poliphoto: repeats, steps, rank64, no, prior, rank128, pivot
polistepz0: steps, pivot, repeats, no, prior
final: baseline, xs
baseline: xl
submodel: xl, dl, sm, tg, baseline, finalmodel
f: r95furrystyle
textual_inversion_apriltag1: object
textual_inversion_apriltag2: object, rainbow
dining: room
coarse: grain, debuged
dogs_3: debuged_1, with_real_prior
painterly: laclair, artstyle, lora, 218mb, 8gb, versions
chinese: basic, lora, aoyagireisyosimo2_regular
dog_8: debuged_1, with_real_prior, debuged_2, lr_e4
coarse_6: debuged_1, with_real_prior, initializer_token_random, pompt_thing, with_rg, initial_random, org, prompt_thing, lr_4, lr_5, prompt_correct, lr_e4
Christmas: critters, sdxl, cookie
Food: photography, 6c09
XSarchitectural: 38interiorforbedroom, 7modern, interior
Cute: comic, sd, 1.5, doodle, sdxl
Detail: tweaker, lora, xl
Fashion: girl, sd, 1.5
CyberRealistic: negative
Age: slider, adult, negative, young, younger
unaestheticXL: negative, ay, jug6, sky3.1
Juggernaut: xl
Realistic: vision
multiplier: face, investigation, new
default: face, new
alice: multiplier
sd20: lora, dreambooth
RealisticVision: lora, lidrs, 4.3
luana: original, realvis15, dreambooth, 1600steps, 1e
potato_dreambooth_2e: 6_800, 6_1200
